77777777777777777
74444111111111447
74444441111434447
74442241411334117
74422221411331117
74422221441131117
74442211111133337
74440001111133337
74441044113333227
74441144013332227
74411110003322227
74411111133322227
74411111133222227
74414411333222227
74444441333222227
74444441333222227
77777777777777777